###################################!!!!!######################################    ||
############!!!!!!!!!!!!###########!!!!!######################################    ||
############!!!!!!!!!!!!!!########!!!!!!!#############!!!!!!!!!###############    ||
############!!!!!!!!!!!!!########!!!!!!!!##########!!!!!!!!!///!##############    ||
###################!!!!!!########!!!!/!!!!########!!!!!!!!!!!//!##############    ||
####################!!!!!!!!!!!!!!!!///!!!##########!!!!!!!!!!!!!#############    ||
########################!!!!!!!!!!!////!!!!#############!!!!!!!!##############    ||
###########################!!!!!!!!!////!!!!!##########!!!!!!!################    ||
##########################!!!!!!!!!!!!!!!!!!!!#######!!!!!!!##################    ||
##############################!!!!!!!!!!!!!!!!!!!!!!!!!!!!!!!!!!!!!!##########    ||
###############################!!!!!!!!!!!!!!!!!!!##########!!!!!!!!!#########    ||
#############################!!!!!!!!!!######################!!!!!//!#########    ||
#########################!!!!!!!!!!############################!!!!!!#########    ||
########################!!!!!!!!!!!###########################################    ||
###########!!!!!!!!!!!!!!!!!!!!!!////!!!!!!!##################################    ||
########### ############!!!##########!!!!!!!!!################################    ||
############!!!####!!!!!!!!!!!!###############################################    ||
############!!!!!!!!!!!!######################################################    ||
############!!!!!!!!##########################################################    ||
##############################################################################    ||
##############################################################################    ||
